1 1 1 1 1 1 1 1 1 0
1 0 0 0 0 0 0 0 1 0
1 0 2 3 3 2 1 0 1 0
1 0 1 3 2 3 2 0 1 0
1 0 2 3 3 2 4 0 1 0
1 0 1 3 2 3 2 0 1 0
1 0 2 3 3 2 1 0 1 0
1 0 0 0 0 0 0 0 1 0
1 1 1 1 1 1 1 1 1 0
0 0 0 0 0 0 0 0 0 0